==Metadata==
=Size=
nlines=12
ncol=35
=Types=
F=1
#000000
W=1000
#FFFFFF
==Graph==
FFFFFFFFFFFFFFFFFFFFFFFFFFFFFFFFFFF
FFFWWWWWWWWWWWWWWWWWWWWWWWWWWWWWFFF
FFFWFFFFFFWWFFFFFFFFFFFFFFFWFFFWFFF
FFFWWWWWWFWWFFFFFFFFFFFFFFFFFWFWFFF
FFFWFFFFFFFFFFFFFFFFFFFFFFWFFFFWFFF
FFFWFFFFFFWWWWWWWWWWWWWWFFFFFFFWFFF
FFFWWWWWWFFFFFFWFFFWFFFWFWFWFWWWFFF
FFFWFFFFWFFFFFFFFWFFFFWWWWFWFWWWFFF
FFFWFFFFWWWWWWWWWWWWWFWFWFFFFFWWFFF
FFFWFFFFWFFFFFWFFFFFWFWFWWFWFWWWFFF
FFFWFFFFFFWWFFFFWFWFFFFFFFFFFWWWFFF
FFFWWWWWWWWWWWWWWWWWWWWWWWWWWWWWFFF
==Path==
Start=2,4
Finish=7,4
